1,6,2,0,3,0,2,0
0,0,2,6,0,7,0,0
4,0,9,0,5,0,4,0
0,3,0,8,0,3,2,0
0,8,9,3,10,0,4,2
0,5,0,0,7,0,8,0
3,0,3,0,2,5,0,11
Monster:
30,Slime
30,Slime
20,Mushroom
20,Mushroom
80,Dragon
80,Dragon
